#######	#######	#######	#######	#######
#######	#######	### ###	#######	#######
#######	### ###	##   ##	### ###	#######
### ###	##   ##	#  @  #	##   ##	### ###
#######	### ###	##   ##	### ###	#######
#######	#######	### ###	#######	#######
#######	#######	#######	#######	#######

#######	#######	#######	#######	#######
#######	### ###	##   ##	### ###	#######
### ###	##@ @##	#     #	##@ @##	### ###
##   ##	#     #	#     #	#     #	##   ##
### ###	##@ @##	#     #	##@ @##	### ###
#######	### ###	##   ##	### ###	#######
#######	#######	#######	#######	#######

#######	#######	#######	#######	#######
###.###	##. .##	#. @ .#	##. .##	###.###
##. .##	#.   .#	#     #	#.   .#	##. .##
#. @ .#	#     #	#@   @#	#     #	#. @ .#
##. .##	#.   .#	#     #	#.   .#	##. .##
###.###	##. .##	#. @ .#	##. .##	###.###
#######	#######	#######	#######	#######

#######	#######	#######	#######	#######
#######	###.###	##. .##	###.###	#######
###.###	##@ @##	#.   .#	##@ @##	###.###
##. .##	#.   .#	#     #	#.   .#	##. .##
###.###	##@ @##	#.   .#	##@ @##	###.###
#######	###.###	##. .##	###.###	#######
#######	#######	#######	#######	#######

#######	#######	#######	#######	#######
#######	#######	###.###	#######	#######
#######	###.###	##...##	###.###	#######
###.###	##...##	#..@..#	##...##	###.###
#######	###.###	##...##	###.###	#######
#######	#######	###.###	#######	#######
#######	#######	#######	#######	#######

